R 1000 1080
NO ./images/bluestone3.xpm
SO ./images/colorstone.xpm
WE ./images/eagle.xpm
EA ./images/graystone.xpm
S ./images/sprite_3.xpm

F 220,100,0
C 255,30,0

        1111111111111111111111111
        1000000000110000000000001
        1011000001110000000000001
        1001000000000000000200001
111111111011000001110000000000001
100000000011000001010111111111111
11110111111111011000010010001
11110111111111011101002010001
110000001101010111000N0000001
10000002000000000000000010001
10000000000000001101010110011
1100000111010101111101111000111
11110111 1110101 101111010001
11111111 1111111 111111111111
